11111111111111111111111111111111
10000000000000000000000000000001
10000000000000000000000000000001
10000000000000000000000000000001
10000000000000000000000000000001
10000000000000000000000000000001
10000111000000000000000000000001
10000000000000000000000000000001
10000000000000000000000000000001
10000000000000000111000000000001
10010000000000000100000000000001
11000110000000011100000000000001
10010010000000010000000000000001
10111010111101110000000000000001
10000010000000000000000000000001
10111111110101111000000000000001
10000010000100000000000000000001
10011010111100000000000000000001
11000000000000000000000000000001
11111111111111111111111111111111